111111111111
1P0000000001
101111111101
101000000101
101011110101
101010C10101
101010010101
101011110101
1010000000C1
1011111111E1
111111111111