111111111111111
1P000000C000001
101111111111101
101000000000101
101011111110101
101010000010101
101010C00010101
101010000010101
101111111110101
1000000C0000101
100000000000E01
111111111111111
