1111111111111111111111
1000000000000000000C11
1010010100100000101001
1010010010101010001001
1P0000000C00C0000000E1
1010010010100010001001
1010010010001010001001
100000000000C000000001
1010010010100010001001
1010010010001010001001
1C00000000000000000001
1111111111111111111111
