1111111111111
1P0000000E001
100000  00001
1000C0  00001
1111111110111
